host_response_rate	host_response_rate
host_listings_count	host_listings_count
host_verificationCount	host_verificationCount
host_since_deltaDays	host_since_deltaDays
calculated_host_listings_count	calculated_host_listings_count
latitude	latitude
longitude	longitude
accommodates	accommodates
bathrooms	bathrooms
bedrooms	bedrooms
beds	beds
price	price
weekly_price	weekly_price
security_deposit	security_deposit
cleaning_fee	cleaning_fee
guests_included	guests_included
extra_people	extra_people
minimum_nights	minimum_nights
maximum_nights	maximum_nights
number_of_reviews	number_of_reviews
last_review_deltaDays	last_review_deltaDays
first_review_deltaDays	first_review_deltaDays
review_scores_rating	review_scores_rating
review_scores_accuracy	review_scores_accuracy
review_scores_cleanliness	review_scores_cleanliness
review_scores_checkin	review_scores_checkin
review_scores_communication	review_scores_communication
review_scores_location	review_scores_location
review_scores_value	review_scores_value
reviews_per_month	reviews_per_month
performance	performance
host_response_time	host_response_time
cancellation_policy	cancellation_policy
host_is_superhost	host_is_superhost
host_has_profile_pic	host_has_profile_pic
host_identity_verified	host_identity_verified
is_location_exact	is_location_exact
instant_bookable	instant_bookable
require_guest_profile_picture	require_guest_profile_picture
require_guest_phone_verification	require_guest_phone_verification
24-Hour_Check-in	24-Hour_Check-in
Air_Conditioning	Air_Conditioning
Breakfast	Breakfast
Buzzer/Wireless_Intercom	Buzzer/Wireless_Intercom
Cable_TV	Cable_TV
Carbon_Monoxide_Detector	Carbon_Monoxide_Detector
Cat(s)	Cat(s)
Dog(s)	Dog(s)
Dryer	Dryer
Elevator_in_Building	Elevator_in_Building
Essentials	Essentials
Family/Kid_Friendly	Family/Kid_Friendly
Fire_Extinguisher	Fire_Extinguisher
First_Aid_Kit	First_Aid_Kit
Free_Parking_on_Premises	Free_Parking_on_Premises
Gym	Gym
Hair_Dryer	Hair_Dryer
Hangers	Hangers
Heating	Heating
Hot_Tub	Hot_Tub
Indoor_Fireplace	Indoor_Fireplace
Internet	Internet
Iron	Iron
Kitchen	Kitchen
Laptop_Friendly_Workspace	Laptop_Friendly_Workspace
Pets_Allowed	Pets_Allowed
Pets_live_on_this_property	Pets_live_on_this_property
Safety_Card	Safety_Card
Shampoo	Shampoo
Smoke_Detector	Smoke_Detector
Suitable_for_Events	Suitable_for_Events
TV	TV
Washer	Washer
Wheelchair_Accessible	Wheelchair_Accessible
Wireless_Internet	Wireless_Internet
property_type_Apartment	property_type_Apartment
property_type_House	property_type_House
room_type_Entire_home/apt	room_type_Entire_home/apt
room_type_Private_room	room_type_Private_room
bed_type_Real_Bed	bed_type_Real_Bed
